111111111111111
10000O000P11111
1CE0S1111111111
11111111111111
111111111111111
111111111111111
