11111
100E1
10C01
1P0M1
11111
11111