1111111111111
10010000001C0
1000011110001
1P0011E000001
1111111111111