1111111111111
10010000001C1
1000011110011
1P0011E0000C1
1111110101111