111111111111111111111111111111111111111111111111
1CCCC1111111111111111111111111111111111111111111
1CECS1111111111111111111111111111111111111111111
1PC0C1111111111111111111111111111111111111111111
1111C1111111111111111111111111111111111111111111
1111C1111111111111111111111111111111111111111111
1111C1111111111111111111111111111111111111111111
1111C1111111111111111111111111111111111111111111
1111C1111111111111111111111111111111111111111111
1111C1111111111111111111111111111111111111111111
1111C1111111111111111111111111111111111111111111
1111C1111111111111111111111111111111111111111111
1111C1111111111111111111111111111111111111111111
1111C1111111111111111111111111111111111111111111
1111C1111111111111111111111111111111111111111111
111111111111111111111111111111111111111111111111
111111111111111111111111111111111111111111111111
111111111111111111111111111111111111111111111111
111111111111111111111111111111111111111111111111
111111111111111111111111111111111111111111111111
111111111111111111111111111111111111111111111111
111111111111111111111111111111111111111111111111
111111111111111111111111111111111111111111111111
111111111111111111111111111111111111111111111111
111111111111111111111111111111111111111111111111