111111111111111111111111111111111111111111111111
1CCCC1111111111111111111111111111111111111111111
1CECC1111111111111111111111111111111111111111111
1PCCC1111111111111111111111111111111111111111111
1111C1111111111111111111111111111111111111111111
1111C1111111111111111111111111111111111111111111
1111C1111111111111111111111111111111111111111111
1111C1111111111111111111111111111111111111111111
1111C1111111111111111111111111111111111111111111
1111C1111111111111111111111111111111111111111111
1111C1111111111111111111111111111111111111111111
1111C1111111111111111111111111111111111111111111
1111C1111111111111111111111111111111111111111111
1111C1111111111111111111111111111111111111111111
1111C1111111111111111111111111111111111111111111
111111111111111111111111111111111111111111111111
111111111111111111111111111111111111111111111111
111111111111111111111111111111111111111111111111
111111111111111111111111111111111111111111111111
111111111111111111111111111111111111111111111111
111111111111111111111111111111111111111111111111
111111111111111111111111111111111111111111111111
111111111111111111111111111111111111111111111111
111111111111111111111111111111111111111111111111
111111111111111111111111111111111111111111111111